...........................................................
.....................#######################...............
......................................############.........
............................................#########......
................##########......................##.........
............................######..............##.........
.##################.............................##.........
...............#................................##.........
...............#................................##.........
................................................##.........
................................................##.........
##.........................................................
##.........................................................
##.........................................................
##.........................................................
##.........................................................
##.........................................................
##.......................###########################..###..
##....................................................###..
##....................................................###..
......................................................###..
......................................................###..
...........................................##############..
...........................................##############..
....########...............................................
...........................................................
...........................................................
...........#########################.......................
...........................................................
...........................................................