...........................................................
.....................#######################...............
......................................############.........
............................................#########......
................##########......................##.........
................................................##.........
................................................##.........
................................................##.........
...........................................................
...........................................................
...........................................................
##.........................................................
##.........................................................
##.........................................................
##.........................................................
##.........................................................
##.........................................................
##......................#######################............
##.........................................................
##.........................................................
...........................................................
...........................................................
...........................................................
...........................................................
...........................................................
...........................................................
...........................................................
...........##############..................................
...........................................................
...........................................................